############################################################
#P 00000000 0000000000000000 0000000 000000 00  00000000 00#
#  00 00 B0000 0000B  000 000 0VV0 000 00 0000000 000 B0000#
#00000 0000  000 00   0000 0000  000 0000000B00000 00  00 0#
#00 0 0 0 00000 000  B00 0 00 0 000 00 0 000000000000000000#
# 0000 000B00000000000 0 0 0 000 000000 000  0 000 000 0 00#
#0 0 00 00000 0 0  0  00 00 00 00000BB00  0000 00 000000000#
#00000 0 00 00 00000000 00000000<#00000000000 000000 0 0## #
#  0000 0 00 000B00 0 000 00 000<#00 0  000 0000 0 00000#G #
#B 00000000000000000000000000000<#00000000000 00B0000000#  #
############################################################