######################
#    VVV             #
#                    #
#                    #
#                    #
#    -          ##   #
#                    #
#>   B               #
#>                   #
#>          0       <#
#>      #   0   G   <#
#      # 0  0        #
#     #         ##   #
# P  #            #  #
#0  #  ^^^## # #     #
######################
######################